ABC	n
ABM	n
AG	n
AGs	n
AKW	n
AKWs	n
ANSI	n
AfA	n
Atu"	n
BGB	law
BGH	n
BGHSt	n
BGS	n
BH	n
BIP	n
BLZ	n
BRD	n
BSE	n
BTX	n
Bafo"g	n
Bsp	n
CD	n
CDs	n
CSFR	n
Co	n
DAX	n
DECT	n
DIN	n
DNA	n
DNS	n
EDV	n
EKG	n
EZB	n
Ecu/S	n
FCKW	n
FKK	n
Fax/TP	n
GAU	n
GHz	unit
GMT	n
GbR	n
GmbH	n
HIV	n
ICE	n
IHK	n
ISBN	n
ISO	n
IT	n
KZ	n
Kfz	n
LCD	n
LSD	n
Lkw/S	n
MHz	n
NGO	n
NGOs	n
NVA	n
OEM	n
PIN	n
PS	n
Pkw/S	n
Pop	n
SOS	n
StGB	law
StPO	law
StVO	law
TNT	n
TV	n
UFO	n
UFOs	n
UKW	n
USA	n
UStG	n
UV	n
WC	n
XP	n
cm	unit
dB	unit
div	n
dm	unit
gGmbH	n
kHz	unit
kW	unit
kWh	unit
kg	unit
km	unit
kp	n
kt	unit
mm	unit
ms	unit
msec	unit
nsec	unit
qm	unit
qmm	unit
