Action	n
Afrolook/S	n
Aftershave/S	n
Airbag/S	n
Airbrush	n
Airline/S	n
Assessmentcenter/SN	n
Aufsplitten/SJ	n
Baby/S	n
Babyphon/SEP	n
Bachelor/S	n
Backgammon	n
Background/S	n
Barkeeper/SNF	n
Baseball	n
Beamer/NS	n
Bigband/S	n
Biker/NSF	n
Blackjack	n
Blacklist/S	n
Blackout/S	n
Blockbuster/SN	n
Blogeintrag/STp	n
Bluejeans	n
Blues	n
Bodyguard/S	n
Booklet/S	n
Boom/S	n
Boy/S	n
Brainstorming/S	n
Broker/FNS	n
Brunch/STE	n
Business	n
Businesslogik	n
Butler/SN	n
Button/S	n
Callboy/S	n
Callcenter/SN	n
Callgirl/S	n
Camp/S	n
Camper/NSF	n
Cartoon/S	n
Chart/S	n
Check/S	n
Cheerleader/NSF	n
Cheeseburger/SN	n
City/S	n
Cleverness	n
Clinch/ST	n
Clip/S	n
Cockpit/S	n
Code/S	n
Comeback/S	n
Comic/S	n
Consulter/SN	n
Consulting/S	n
Container/SN	n
Copyright/S	n
Cornedbeef	n
Cornflakes	n
Countdown/S	n
Cover/SN	n
Cowboy/S	n
Crash/S	n
Crew/S	n
Crowdfunding/S	n
Deadline/S	n
Deal/S	n
Dealer/NFS	n
Design/S	n
Designer/SNF	n
Display/S	n
Distributor/SP	n
Double/S	n
Dress/TE	n
Dressman	n
Drummer/NSF	n
Dummy/S	n
Einchecken/S	n
Emoticon/S	n
Engineering/Sn	n
Entertainer/NSF	n
Equalizer/SN	n
Equipment/S	n
Essay/S	n
Essayist/PF	n
Establishment/S	n
Fairness/U	n
Fallout	n
Fan/S	n
Fanclub/S	n
Fangemeinde	n
Farbdisplay/S	n
Feature/S	n
Feedback/S	n
Firmware	n
Flatrate/S	n
Flowerpower	n
Flyer/SN	n
Foul/S	n
Freeclimbing/S	n
Freejazz	n
Frisbee/S	n
Fulltimejob/S	n
Gangway/S	n
Gentleman	n
Ghostwriter/SN	n
Glamour/S	n
Grunge	n
Haarspray/S	n
Handy/S	n
Happyend/S	n
Hardcore	n
Hardcover/S	n
Hardrock/S	n
Hardware	n
Heavymetal	n
Highfidelity	n
Highheels	n
Highlight/S	n
Highsociety	n
Hit/S	n
Hobby/S	n
Hobbyist/PF	n
Homecomputer/SN	n
Homeland	n
Homepage/S	n
Hotdog/S	n
Image/S	n
Insider/NSF	n
Intercity/S	n
Interface/S	n
Intershop/S	n
Investment/S	n
Jeans	n
Jet/S	n
Job/S	n
Jobsharing/S	n
Jogger/NSF	n
Jogging/S	n
Jointventure/S	n
Jumbojet/S	n
Junkie/S	n
Jury/S	n
Karbon	n
Keyboard/S	n
Kidnapper/NSF	n
Killer/NSF	n
Klonen/SJ	n
Lady/S	n
Leggings	n
Level/S	n
Lift/STEP	n
Liveu"bertragung/P	n
Lobby/S	n
Lobbyist/PF	n
Lovestory/S	n
Lunchpaket/EPS	n
Mainstream	n
Mastermind	n
Meeting/S	n
Midlifecrisis	n
Mister	n
Mobbing	n
Multiplechoicefrage/N	n
Multiplechoiceverfahren/S	n
Newcomer/NSF	n
Notebook/S	n
Oldtimer/S	n
Outsider/NSF	n
Outsourcing	n
Party/S	n
Patchwork	n
Peak/S	n
Peepshow/S	n
Performance	n
Piercing/S	n
Pin/S	n
Plattenlabel/S	n
Playback	n
Playboy/S	n
Player/NS	n
Plotter/SN	n
Pony/S	n
Poolbillard/S	n
Posting/Sn	n
Power	n
Providerwechsel/SN	n
Pub/S	n
Queen	n
Rallye/S	n
Randomisieren/SJ	n
Rating/S	n
Ratingagentur/P	n
Recycling/S	n
Reggae	n
Reliabilita"t	n
Reset/S	n
Review/S	n
Roadmap/S	n
Rowdy/S	n
Safe/S	n
Sample/S	n
Sandwich/S	n
Scanner/SN	n
Sciencefiction	n
Selfmademan	n
Sequenzer/NS	n
Set/S	n
Sexappeal/S	n
Shampoo/S	n
Shop/S	n
Shorts	n
Shortstory/S	n
Show/S	n
Showdown/S	n
Single/S	n
Skateboard/S	n
Skipper/NSF	n
Skooter/NS	n
Smartphone/S	n
Smiley/S	n
Smog/S	n
Smoking	n
Snackbar	n
Snob/S	n
Software	n
Song/S	n
Sound/S	n
Soundtrack/S	n
Sponsoring/S	n
Spot/S	n
Statement/S	n
Steward/S	n
Stewardess/P	n
Story	n
Stripper/NSF	n
Striptease	n
Stunt/S	n
Stuntman	n
Stylist/PF	n
Support/S	n
Sweatshirt/S	n
Swimmingpool/S	n
Swing	n
Talkmaster/SNF	n
Talkshow/S	n
Tattoo/S	n
Teamwork	n
Techno	n
Teddy/S	n
Teenager/NSF	n
Teleshopping	n
Thriller/NS	n
Tiebreak/S	n
Toaster/NS	n
Trailer/SN	n
Tranquilizer	n
Trendsetter/SNF	n
Trolley/S	n
Underdog	n
Verlinken/SJ	n
Videoclip/S	n
Whistleblower/SNF	n
Whitelist/S	n
Workaholic/S	n
Wrestling	n
abgescannt/A	aa
andocken/DIXY	v
angedockt/A	aa
anpinnen/DIXY	v
aufsplitten/IXYD	v
boomen/DIXY	v
cool/AC	aa
designen/D
designt/XA	aa
designtest
einchecken/DIXY	v
eingecheckt/A	aa
eingescannt/A	aa
einscannen/DIXY	v
einzuscannen/D
fair/ACU	aa
fit
fitte/AC	aa
gefloppt/A	aa
gejoggt
geklont/A	aa
geleast/A	aa
gelinkt/A	aa
gemailt
geschreddert/A	aa
gesplittet/A	aa
gesponsert/A	aa
getrampt
heranzoomen/DIXY	v
hineinzoomen/DIXY	v
joggen/DIXYW	v
klonen/BDIXYW	v
live
performant/AC	aa
puschen/DIXY	v
pushen/DIXY	v
randomisieren/IOXYW	v
recyceln/BDIOXYW	v
relaxed
relaxen/DIW	v
scannen/DIXYW	v
schreddern/DIXYW	v
sexy
splitten/IXYD	v
sponsern/DIXY	v
strippen/DIXYW	v
swingen/DIVX	v
teamfa"hig/A	aa
topfit
trampen/DIXYW	v
unfair/AC	aa
verlinkt/A	aa
webbasiert/A	aa
