Adjunkt/P	n
Akquisitor/SP	n
Blunzn	n
Brezels	n
Cappy	n
DachgeschosS/ETP	n
Dekagramm	n
Dirn/P	n
Eierschwammerl	n
Eierspeise	n
Einspa"nner	n
Erdapfel/S	n
ErdgeschosS/ETP	n
Erda"pfel/N	n
Essigwurst	n
Faschierte/SN	n
Fiaker/S	n
Fisole/N	n
Fleischbank	n
Fleischba"nke/N	n
Fleischhauer/NS	n
Fleischhauerei/P	n
Fleischlaibchen	n
Fleischlaiberl/N	n
Fleischmaschine/N	n
Fritatten	n
Gelse	n
Gendarmerie	n
Germ	n
Geschaftlhuber/NS	n
GeschosS/ETP	n
Geselchte/NS	n
Gespritzte/S	n
Gleichenfeier/N	n
Greissler	n
Gschaftlhuber/NS	n
Gschnasfest	n
Gschnast	n
Gstanzel/NS	n
Haberer/NS	n
Haxe/N	n
Hendl/NS	n
Herrenpilz/EPT	n
Ha"fen/S	n
Ha"unel/NS	n
Ha"uptel/NS	n
Ha"uptelsalat	n
Jause/N	n
Ja"nner/S	n
Kampl	n
Karfiol	n
KellergeschosS/ETP	n
Klampfe	n
Kohlsprossen	n
Kracherl	n
Krapfen	n
Krautha"upl	n
Kren	n
Kukuruz	n
Ko"rndlbauer/NS	n
Ku"cken/S	n
Leintuch	n
Leintu"cher	n
Lungenbraten	n
Marille/N	n
Mascherl/N	n
Matura	n
Maturant/PF	n
Melange/N	n
Mistku"bel/NS	n
Nudelwalker/SN	n
ObergeschosS/ETP	n
Palatschinke/N	n
Paradeiser/SN	n
Pensionist/NF	n
Pfuscher	n
Pickerl/N	n
Piefke/S	n
Povidl	n
Povoir	n
Pralinee/S	n
Praline'/S	n
Putzerei	n
Quargel/NS	n
Rauchfangkehrer/NS	n
Ribisel	n
Russ/T	n
Sackerl	n
Sandler/NS	n
Schafblattern	n
Schanigarten/S	n
Scheibtruhe	n
Scherzel	n
Schlagobers	n
Schlampertatsch	n
Schlapfen/S	n
Schma"h/S	n
Schneck/S	n
Schneckerl/SN	n
Schwammerl/NS	n
Schwarzbeere/N	n
Spass/T	n
Spassetln	n
Speis	n
Spritzkrug/Sp	n
Stadel/SN	n
Stamperl/SN	n
Stockerl/SN	n
Stoppelzieher/NS	n
Striezel/SN	n
Strizzi/S	n
Szepter/SN	n
Topfen/S	n
Trafik/P	n
Trum/S	n
Tschick/S	n
Tschusch/P	n
Tuchent/P	n
Tu"rschnalle/N	n
UntergeschosS/ETP	n
Vogerlsalat/SEPT	n
Wimmerl/NS	n
WurfgeschosS/ETP	n
Zwetschkenro"ster	n
ZwischengeschosS/ETP	n
brenzlich/A	aa
ehest
faschieren/IXYDW	v
gesamthaft/A	aa
geschamig/A	aa
gescha"mig/A	aa
gespieben
gschamig/A	aa
gscha"mig/A	aa
hetzig/A	aa
innert
maschinschreiben/DIX	v
maschinschriftlich/A	aa
maturieren/IXYD	v
nachhause
punkto
raunzen/IXYDW	v
resch/A	aa
scheiben/IXDW	v
schiech/A	aa
schnakseln/IXY	v
sekieren/IXYDW	v
selchen/IXYDW	v
speiben/IXDW	v
strabanzen/IXYDW	v
strawanzen/IXYDW	v
sudern/IXYDW	v
trenzen/IXYDW	v
urgieren/DIOXY	v
verbandelt/A	aa
watschen/IXYW	v
weiters
zuhause
zulieb
