Abszisse/N	n
Abza"hlbarkeit/P	n
Adjunktion/P	n
Algebra	n
Algebren	n
Allquantor/PS	n
Analysis	n
Ankathete/N	n
Asymptote/N	n
Automorphismen	n
Automorphismus	n
Basisvektor/SP	n
Bernoulli/S	n
Beweisidee/N	n
Beweisschritt/EPS	n
Bezierkurve/N	n
Bijektion/P	n
Bildbereich/EPS	n
Binom/SEP	n
Binomialkoeffizient/P	n
Binomialreihe/N	n
Biplot/S	n
Cholesky/S	n
Deduktionsmethode/N	n
Deduktionsregel/N	n
Deduktionsschema	n
Definitionsbereich/EPS	n
Determinante/N	n
Differenzvektor/SP	n
Eigenvektor/SP	n
Eigenwert/ESTP	n
Eineindeutigkeit/P	n
Einheitsvektor/SP	n
Endomorphismen	n
Endomorphismus	n
Epimorphismen	n
Epimorphismus	n
Existenzquantor/SP	n
Fakulta"tsfunktion	n
Fixpunktbildung	n
Fixpunktgleichung/P	n
Fixpunktiteration/P	n
Fixpunktoperator	n
Fixpunktsatz/T	n
Fixpunktverfahren	n
Folgenglied/RS	n
Fourieranalyse/N	n
Fouriertransformation/P	n
Halbgruppe/N	n
Homomorphie	n
Homomorphismen	n
Homomorphismus	n
Hyperbel/N	n
Hypotenuse/N	n
Identita"tsfunktion/P	n
Imagina"rteil/SEP	n
Imputation/P	n
Indexgrenze/N	n
Induktionsanfang	n
Induktionsannahme/N	n
Induktionsaussage/N	n
Induktionsbeginn/S	n
Induktionsbeweis/EPT	n
Induktionshypothese/N	n
Induktionsmethode/N	n
Induktionsprinzip	n
Induktionsschluss/Tp	n
Induktionsschritt	n
Induktionsvoraussetzung	n
Infimum	n
Inklination/P	n
Integral/SEP	n
Isomorphie	n
Isomorphismen	n
Isomorphismus	n
Iteration/P	n
Kathete/N	n
Kombinatorik	n
Komplement/EPS	n
Komplementbildung	n
Konchoide/N	n
Kongruenz	n
Konkatenation	n
Korrektheitsbeweis/EPT	n
Kosinus	n
Kovarianz/P	n
Kreuzprodukt/SEP	n
Laufindex/EPT	n
Laufindices	n
Linearisierung/P	n
Mantisse/N	n
Matrices	n
Matrix	n
Matrixelement/EPST	n
Matrizen	n
Matrizes	n
Mengenoperation/P	n
Mengenverband/ST	n
Monomorphismen	n
Monomorphismus	n
Morphismen	n
Morphismus	n
Normalform/P	n
Normalisierung	n
Nullstelle/N	n
Obermenge/N	n
Oktant/P	n
Orthogonalita"t	n
Orthonormalsystem/SEP	n
Ortskoordinate/N	n
Ortsvektor/SP	n
Paraboloid/STEP	n
Passante	n
Permutation/P	n
Polarkoordinaten	n
Polynom/SEP	n
Potenzreihe/N	n
Primzahl/P	n
Quadrupel/NS	n
Reihenentwicklung/P	n
Reihung/P	n
Stufenfunktion/P	n
Substitution/P	n
Subtangente/N	n
Suprema	n
Supremum/S	n
Teilausdruck/S	n
Teilausdru"cke/N	n
Teilmengenrelation/P	n
Tensor/S	n
Tensorgleichung/P	n
Term/EPS	n
Termdarstellung/P	n
Termersetzung/P	n
Termersetzungsregel/N	n
Termersetzungssystem/EPS	n
Topologie	n
Tori	n
Torus	n
Tupel/SN	n
Tupelbildung	n
Ursprungswert/EPS	n
Variablensubstitution/P	n
Varianz/P	n
Vektorisieren/SJ	n
Vektorrechnung	n
Volumenelement/EPS	n
Vorfaktor/SP	n
Wahrscheinlichkeitsfunktion/P	n
Wahrscheinlichkeitsverteilung/P	n
Wellenfunktion/P	n
Zusatzterm/SEP	n
Zykloide/N	n
abelsch/A	aa
adjungiert/A	aa
algorithmisch/A	aa
asymptotisch/A	aa
axiomatisch/A	aa
bijektiv/A	aa
binomisch/A	aa
cartansch/A	aa
deduktiv/A	aa
deduzieren/IXYDO	v
diagonalisieren/BIXYO	v
dimensionslos/A	aa
disjunktiv/A	aa
eulersch/A	aa
hessesche/A	aa
hexagonal/A	aa
hilbertsch/A	aa
hyperbolisch/A	aa
imputieren/DIOXYW	v
infinitesimal/A	aa
injektiv/A	aa
iterativ/A	aa
iterieren/DIOXY	v
kollinear/A	aa
kommutativ/A	aa
komplanar/A	aa
konkatenieren/IOXY	v
kubieren/DIOXYW	v
natu"rlichzahlig/A	aa
nullte/A	aa
quantorenfrei/A	aa
riemannsch/A	aa
taylorisieren/IXYDB	v
vorzeichenrichtig/A	aa
zahlentheoretisch/A	aa
A"quivalenzklassenbildung	n
A"quivalenzrelation/P	n
u"berabza"hlbar/A	aa
