Abduktor/SP	n
Adduktorenzerrung/P	n
Adipositas	n
Adoleszenz	n
Afferenz/P	n
Akupressur/P	n
Akupunktur/P	n
Albinismus	n
Androgene/N	n
Antidepressiva	n
Antiemetikum/S	n
Antigen/EP	n
Antihistaminika	n
Antihistaminikum/S	n
Antimykotikum/S	n
Antiseptika	n
Antiseptikum/S	n
Ana"sthesie	n
Ana"sthesist/PF	n
Ana"sthetika	n
Ana"sthetikum/S	n
Apertur/P	n
Arteriosklerose/N	n
Arthritis	n
Arthrose/N	n
Behaviorismus	n
Biopsie/N	n
Borderline	n
Borderlinesyndrom/ESP	n
Bronchien	n
Bulimie	n
Cellulitis	n
Chirotherapie/N	n
Clenbuterol/S	n
Computertomograph/P	n
Cortison	n
Denitrifikation	n
Desoxyribonukleinsa"ure/N	n
Diarrho"/P	n
Downsyndrom/SEPT	n
Dyslexie/N	n
Eileiter/SN	n
Endorphin/SEP	n
Endoskopie	n
Epidemiologie	n
Ergometer/SN	n
Erythrozyt/P	n
Eugenik	n
Eugeniker/NSF	n
Eutrophie	n
Eutrophika	n
Eutrophikum/S	n
Fibrille/N	n
Fluorid/ESTP	n
Gestose/N	n
Harnwegsinfektion/P	n
Hepatitis	n
Histologe/NF	n
Histologie	n
Hospitalismus	n
Hyposensibilisierung	n
Ha"matom/SEP	n
Ha"moglobin	n
Ha"mophilie/N	n
Indolenz/P	n
Influenza	n
Inkubationszeit/P	n
Insuffizienz/P	n
Iris	n
Ischias	n
Kaliumpermanganat	n
Kanu"le/N	n
Kardiograf/P	n
Kardiogramm/ST	n
Kardiograph/P	n
Kardiologe/NF	n
Kardiologie	n
Katheter/NS	n
Kernspintomografie	n
Kognitivismus	n
Koloskop/EPS	n
Koloskopie/N	n
Kontagiosita"t	n
Kortex/TEP	n
Kurzatmigkeit	n
Kyphose	n
Letalita"t	n
Leuka"mie	n
Lipide/N	n
Logopa"die	n
Lymphgefa"sS/EPT	n
Lymphknoten/S	n
Mammographie/N	n
Mannit	n
Melanom/SEP	n
Metabolismus	n
Methadon	n
Morbus	n
Morphium/S	n
Mumps	n
Mundfa"ule	n
Neuraltherapie	n
Neurodermitis	n
Neuron/P	n
Osteoporose	n
Parakinese/N	n
Parkinson/S	n
Parodontose/N	n
Pharmakodynamik	n
Pharmakokinetik	n
Plazenta	n
Polyarthritis	n
Provitamin/EPS	n
Psychopharmaka	n
Psychosomatik	n
Pyelogramm/ESP	n
Pa"diatrie	n
Rachitis	n
Rekonvaleszenz	n
Residuen	n
Residuum/S	n
Rheumatismus	n
Sarkom/SEP	n
Sarkoma	n
Sarkomatose	n
Schambein/STEP	n
Scharlach	n
Schleimpfropf/ST	n
Stethoskop/SEP	n
Struma	n
Szintigramm/SEP	n
Tetanus	n
Tetanusimpfung/P	n
Tetanusprophylaxe	n
Thorax/EP	n
Thromben	n
Thrombozyt/P	n
Thrombus	n
Tinnitus	n
Tomographie	n
Trimenon	n
Trismen	n
Trismus	n
Tubus/q	n
Urologe/NF	n
Urologie	n
Vaginalkanal/S	n
Vasektomie/N	n
Viszeral	n
Vulva	n
Vulven	n
Zellulitis	n
aerob/A	aa
afferent/A	aa
anaerob/A	aa
anaphylaktisch/A	aa
antibiotisch/A	aa
antiseptisch/A	aa
ana"sthesieren
ana"sthetisch/A	aa
ana"sthetisieren
arthritisch/A	aa
aseptisch/A	aa
endoskopisch/A	aa
erektil/A	aa
histologisch/A	aa
hochkontagio"s/A	aa
immunologisch/A	aa
kardiologisch/A	aa
kontagio"s/A	aa
kurativ/A	aa
letal/A	aa
menstrual/A	aa
metabol
metabolisch/A	aa
muskula"r/A	aa
postnatal/A	aa
postoperativ/A	aa
pra"natal/A	aa
psychotisch/AC	aa
pa"diatrisch/A	aa
residual/A	aa
rezidiv/A	aa
somatisch/A	aa
subkutan/A	aa
systolisch/A	aa
thrombotisch/A	aa
toxisch/A	aa
urologisch/A	aa
vaginal/A	aa
viszeral/A	aa
O"strogen/EPS	n
