Abbaugera"t	n
Abbaugera"usche	n
Abbauleistung	n
Abbauleitzentrale/N	n
Abbaumaschine/N	n
Abbaumaterial/S	n
Abbaumenge/N	n
Abbrand/S	n
Abbra"nde/N	n
Abfallkurve/N	n
Abfo"rdermenge/N	n
Abgriffspannung/P	n
Abklingverhalten	n
Ablauffolge/N	n
Ablaufsteuerung/P	n
Ablaufsteuerwerk/S	n
Abschaltrelais	n
Abschirmeffekt/EPS	n
Abschirmzuleitung/P	n
Abschlussstecker/SN	n
Abschlusswiderstand/S	n
Abschmiernippel/NS	n
Abschottzylinder/SN	n
Absorbens	n
Absorbenzien	n
Abstellzeit/P	n
Abstrahlcharakteristik/P	n
Abstrahlwinkel/SN	n
Abwassertechnik	n
Acidum	n
Adaptergeha"use/NS	n
Adapterkabel/SN	n
Adapterkarte/N	n
Adapterleiste/N	n
Adaptermodul/SP	n
Adapterplatine/N	n
Adaptionsplatine	n
Adha"sionsbruch	n
Adiabat/SEP	n
Adsorbens	n
Adsorbentia	n
Adsorbenzien	n
Adsorption/P	n
Adsorptionsdynamik	n
Adsorptionsgleichgewicht/S	n
Adsorptionskinetik	n
Aeronautik	n
Aerosol/SEP	n
Aerostatik	n
Aggregatzustand/ST	n
Aggregatzusta"nde/N	n
Akkubetrieb/S	n
Akkumulatorenbatterie/N	n
Akkumulatorfahrzeug/PE	n
Akustiksensor/P	n
Akzeleration	n
Alugeha"use/SN	n
Aluminiumblech	n
Aluminiumgeha"use/N	n
Aluminiumpulver	n
Aluminiumrinnen	n
Aluplatte/N	n
Alupla"ttchen	n
Ammonium/S	n
Amplitudenbereich	n
Amplitudenda"mpfung	n
Amplitudenmodulation	n
Amplitudenregelung	n
Amplitudenverteilung	n
Amplitudenwerte	n
Analogausgabe	n
Analogausgang/ST	n
Analogausga"nge	n
Analogbus	n
Analogeingang	n
Analogeinga"nge/N	n
Analogkana"le	n
Analogkarten	n
Analogmultiplexer	n
Analogschalter	n
Analogsignal/ESP	n
Analogspannung/P	n
Analogspannungsspeicher	n
Analogteil/S	n
Analogtor	n
Analogwandler	n
Analogwert/E	n
Anbauplatte	n
Angstdioden	n
Anion/SEP	n
Ankerstellung/P	n
Ankerwicklung/P	n
Anklemmung	n
Anode/N	n
Anpasshardware	n
Anpressdruck/ST	n
Anthracen/EPS	n
Apside/N	n
Argon/S	n
Asynchronmotor/SP	n
Ausdehnungskoeffizient/P	n
Autonomisieren/SJ	n
Barbitursa"ure/N	n
Bias	n
Bismut/S	n
Boson/PSn	n
Californium/S	n
Cobalt/S	n
Ca"sium/S	n
Desorption	n
Dezibel	n
Diffusionskonstante	n
Diffusionsla"nge	n
Diffusionsstrom	n
Diffusionsstromdichte/N	n
Dipol/SEP	n
Dispersion	n
Dopplereffekt/STEP	n
Drehimpuls/TEP	n
Dysprosium/S	n
Elektronenbahn/P	n
Elektronenmasse/N	n
Elementarladung/P	n
Ellipsengleichung/P	n
Energieerhaltung	n
Energieniveau/S	n
Energiespektrum/S	n
Enthalpie/N	n
Entropie/N	n
Erlenmeyerkolben/S	n
Europium/S	n
Eutrophieren/SJ	n
Extrema	n
Extremum/S	n
Ferromagnetismus	n
Festko"rper/SN	n
Festko"rperphysik/R	n
Filtrat/EPST	n
Filtration/P	n
Frequenzverha"ltnis/Qq	n
Gesamtenergie	n
Gesamtwiderstand/S	n
Gigawatt	n
Gitterkonstante/N	n
Halbdot/S	n
Halbdottechnik	n
Huminsa"ure/N	n
Hysterese	n
Interferenzmuster/SN	n
Isobar/EPS	n
Isotop/ESP	n
Katalysestoff/ESPT	n
Kontinuum/S	n
LCR	n
Ladungstra"ger/SN	n
Lanthan/S	n
Lanthanoid/EPS	n
Leitfa"higkeit/P	n
Lumen/S	n
Megawatt	n
Messanordnung/P	n
Messkurve/N	n
Messprobe/N	n
Metallschicht/P	n
Millisievert	n
Milliwatt	n
Mol/SEP	n
Nachkommastelle/N	n
Nanometer/N	n
Neodym/S	n
Neutrino/S	n
Nullleiter/S	n
Nullstellenbestimmung	n
Phasenbeziehung/P	n
Phasenfunktion/P	n
Polyethylen	n
Potenzialbarriere/N	n
Potenzialtopf	n
Potenzialverlauf/p	n
Quantendynamik	n
Resonanzbedingung/P	n
Ruhemasse/N	n
Sattelpunkt/EPST	n
Scandium/S	n
Schichtaufbau/S	n
Schichtfolge/N	n
Schichtstruktur/P	n
Schro"dingergleichung	n
Sendeeinheit/P	n
Sievert	n
Standardabweichung/P	n
StosSvorgang/Sp	n
Strahlteiler/NS	n
Streuwinkel/SN	n
Strontium/S	n
Sto"rstelle/N	n
Sulfat/EPST	n
Sulfid/EPST	n
Teilabbildung/P	n
Telematik	n
Terbium/S	n
Totzeit	n
Triangulation/P	n
Triangulieren/SJ	n
Tunnelwahrscheinlichkeit/P	n
Unscha"rferelation	n
Valenz/P	n
Valenzband/T	n
Windungszahl/P	n
Wirkungsquantum	n
Ytterbium/S	n
Yttrium/S	n
Zeitintegral/EPS	n
Zyklotron/EPS	n
aderig/A	aa
adiabatisch/A	aa
adsorptiv/A	aa
aeronautisch/A	aa
aliphatisch/A	aa
anastatisch/A	aa
ancrimpbar
ancrimpen
anisotrop/A	aa
anklemmen/IXY	v
anlaufgeschu"tzt/A	aa
aperiodisch/A	aa
beaufschlagen/IXYDO	v
bistabil/A	aa
bohrsch/A	aa
coaten/IXYD	v
dazugeschaltet/A	aa
einbrennlackieren/IXYDO	v
endotherm/A	aa
energetisch/A	aa
eutroph/A	aa
eutrophieren/DIOXY	v
exotherm/A	aa
ferneingestellt/A	aa
fernkontrolliert/A	aa
ferromagnetisch/A	aa
frequenzunabha"ngig/A	aa
funktechnisch/A	aa
gecoatet
gejittert
gelatcht
gemultiplext
getriggert
herauszuversta"rken/D
hergeschaltet
hochrein/A	aa
ionisieren/DIOXY	v
isobar/A	aa
isotrop/A	aa
kabelseitig/A	aa
kaltgeha"mmert/A	aa
kaltgeha"rtet/A	aa
kaltgera"uchert/A	aa
kaltgeschmiedet/A	aa
kaltgezogen/A	aa
kaltha"mmern/DIXY	v
kaltschmieden/DIXY	v
kanalig/A	aa
kavito"s/A	aa
longitudinal/A	aa
molar/A	aa
nachgetriggert/A	aa
nachtriggern/IXYDB	v
newtonsche/A	aa
petrochemisch/A	aa
plancksche/A	aa
potentiometrisch/A	aa
quantenmechanisch/A	aa
rumlo"ten/IXYD	v
ru"ckgesetzt/A	aa
ru"cksetzen/IXYD	v
sandgekapselt/A	aa
sinusfo"rmig/A	aa
spannungsversorgt/A	aa
steilheitsbegrenzt/A	aa
strombegrenzt/A	aa
sulfidisch/A	aa
takten/IXYD	v
teilbestu"cken/O	v
transistorisieren/IXYDO	v
triangulieren/DIOXYW	v
triggern/IXYDB	v
unterbrechungsgesteuert/A	aa
vorversta"rken/IXYDO	v
weggeschaltet
weichlo"ten/IXYD	v
zeitabha"ngig/A	aa
zeitunabha"ngig/A	aa
zusammengekoppelt/A	aa
A"thyl	n
